+++++++++++++++++++++++
   +   ++ ++         ++
+     +     ++  +++++++
+ +   +++  +++  +++ +++
+ +   + + ++      +  ++
+          ++  ++  + ++
+++++ + +      ++  + ++
+++++ +++  + +  ++   ++
+          + +  + +  ++
+++++ +  + + +   S + ++
+++++++++++++++++++++++